0 0 0 0 0 0 0
0 4 0 5 0 7 0
0 + 0 + 0 + 0
0 3 + 2 + 6 0
0 0 0 + 0 0 0
0 0 0 1 0 0 0
0 0 0 0 0 0 0
